30 30 30 30 30 30 30 30 30 30 30 30 30 30 30 30 30 30 30 30 30 30 30 30 30 30 30 30 30 30 30 30 30 30 30 30 30 30 30 30 30 30 30 30 30 30
30 30 30 30 30 30 30 30 30 30 30 30 30 30 30 30 30 30 30 30 30 30 30 30 30 30 30 30 30 30 30 30 30 30 30 30 30 30 30 30 30 30 30 30 30 30
30 30 30 30 30 30 30 30 30 30 30 30 30 30 30 30 30 30 30 30 30 30 30 30 30 30 30 30 30 30 30 30 30 30 30 30 30 30 30 30 30 30 30 30 30 30
30 30 30 30 30 30 30 30 30 30 30 30 30 30 30 30 30 30 30 30 30 30 30 30 30 30 30 30 30 30 30 30 30 30 30 30 30 30 30 30 30 30 30 30 30 30
30 30 30 30 30 30 30 30 30 30 30 30 30 30 30 30 30 30 30 30 30 30 30 30 30 30 30 30 30 30 30 30 30 30 30 30 30 30 30 30 30 30 30 30 30 30
30 30 30 30 30 30 30 30 30 30 30 30 30 30 30 30 30 30 30 30 30 30 30 30 30 30 30 30 30 30 30 30 30 30 30 30 30 30 30 30 30 30 30 30 30 30
30 30 30 30 30 30 30 30 30 30 30 30 30 30 30 30 30 30 30 30 30 30 30 30 30 30 30 30 30 30 30 30 30 30 30 30 30 30 30 30 30 30 30 30 30 30
30 30 30 30 30 30 30 37 32 32 32 32 32 32 32 32 32 32 32 32 32 32 32 32 32 32 32 32 32 32 32 32 32 32 32 32 41 30 30 30 30 30 30 30 30 30
30 30 30 30 30 30 30 31 46 36 36 36 36 36 36 36 36 36 36 36 36 36 36 36 36 36 36 36 36 36 36 36 36 36 36 45 38 30 30 30 30 30 30 30 30 30
30 30 30 30 30 30 30 31 35 29 29 29 29 29 29 29 29 29 58 58 58 58 58 58 58 29 29 29 29 29 29 29 29 29 29 33 38 30 30 30 30 30 30 30 30 30
30 30 30 30 30 30 30 31 35 29 29 29 29 29 29 29 29 29 29 58 58 58 58 58 29 29 29 56 29 29 29 29 57 29 29 33 38 30 30 30 30 30 30 30 30 30
30 30 30 30 30 30 30 31 35 29 29 29 29 29 48 49 49 50 29 29 58 58 58 58 29 29 29 29 29 48 50 29 29 29 29 33 38 30 30 30 30 30 30 30 30 30
30 30 30 30 30 30 30 31 35 29 29 29 48 49 30 30 30 51 29 29 58 58 58 29 29 56 29 29 29 54 52 29 29 29 29 33 38 30 30 30 30 30 30 30 30 30
30 30 30 30 30 30 30 31 35 29 56 29 54 30 30 30 30 52 29 29 29 58 56 29 29 29 29 29 57 29 29 29 29 29 29 33 38 30 30 30 30 30 30 30 30 30
30 30 30 30 30 30 30 31 35 29 29 29 48 30 30 30 51 29 29 29 29 29 29 29 29 29 29 29 29 29 58 29 57 29 29 33 38 30 30 30 30 30 30 30 30 30
30 30 30 30 30 30 30 31 35 56 29 29 54 53 53 53 52 29 29 29 56 29 58 29 56 29 29 29 29 29 29 29 29 29 56 33 38 30 30 30 30 30 30 30 30 30
30 30 30 30 30 30 30 31 35 29 29 29 29 29 29 29 29 29 29 29 29 29 58 58 29 29 29 29 29 29 29 29 29 58 29 33 38 30 30 30 30 30 30 30 30 30
30 30 30 30 30 30 30 31 35 29 29 29 29 29 57 29 29 29 29 29 29 29 58 58 58 29 29 29 29 29 56 29 29 29 29 33 38 30 30 30 30 30 30 30 30 30
30 30 30 30 30 30 30 31 35 29 29 29 57 29 29 29 29 29 29 29 29 48 49 49 49 50 29 29 29 29 29 29 56 29 29 33 38 30 30 30 30 30 30 30 30 30
30 30 30 30 30 30 30 31 35 29 29 29 29 29 29 58 29 29 29 29 29 55 30 30 30 51 29 29 58 29 29 29 57 29 29 33 38 30 30 30 30 30 30 30 30 30
30 30 30 30 30 30 30 31 35 29 57 29 29 29 29 29 29 29 29 29 29 55 30 30 30 51 29 29 29 29 29 29 29 29 29 33 38 30 30 30 30 30 30 30 30 30
30 30 30 30 30 30 30 31 35 29 29 29 29 29 29 56 29 29 29 29 29 54 53 53 53 52 29 29 29 29 29 29 29 29 29 33 38 30 30 30 30 30 30 30 30 30
30 30 30 30 30 30 30 31 35 29 29 56 29 29 29 29 29 29 29 29 29 58 29 29 29 29 29 57 29 29 29 29 59 60 61 33 38 30 30 30 30 30 30 30 30 30
30 30 30 30 30 30 30 31 35 29 29 29 29 29 29 29 29 29 29 29 29 29 29 29 58 29 29 29 29 29 29 29 62 63 64 33 38 30 30 30 30 30 30 30 30 30
30 30 30 30 30 30 30 31 47 34 34 34 34 34 34 34 34 34 34 34 34 34 34 34 34 34 34 34 34 34 34 34 34 34 34 44 38 30 30 30 30 30 30 30 30 30
30 30 30 30 30 30 30 40 39 39 39 39 39 39 39 39 39 39 39 39 39 39 39 39 39 39 39 39 39 39 39 39 39 39 39 39 42 30 30 30 30 30 30 30 30 30
30 30 30 30 30 30 30 30 30 30 30 30 30 30 30 30 30 30 30 30 30 30 30 30 30 30 30 30 30 30 30 30 30 30 30 30 30 30 30 30 30 30 30 30 30 30
30 30 30 30 30 30 30 30 30 30 30 30 30 30 30 30 30 30 30 30 30 30 30 30 30 30 30 30 30 30 30 30 30 30 30 30 30 30 30 30 30 30 30 30 30 30
30 30 30 30 30 30 30 30 30 30 30 30 30 30 30 30 30 30 30 30 30 30 30 30 30 30 30 30 30 30 30 30 30 30 30 30 30 30 30 30 30 30 30 30 30 30
30 30 30 30 30 30 30 30 30 30 30 30 30 30 30 30 30 30 30 30 30 30 30 30 30 30 30 30 30 30 30 30 30 30 30 30 30 30 30 30 30 30 30 30 30 30
30 30 30 30 30 30 30 30 30 30 30 30 30 30 30 30 30 30 30 30 30 30 30 30 30 30 30 30 30 30 30 30 30 30 30 30 30 30 30 30 30 30 30 30 30 30