1 1 1 1 1 1 1 1 1 1 1 1 1 1 1 1 1 1 1 1 1 1 1 1 1 1 1 1 1 1 1 1 1 1 1 1 1 1 1 1 1 1 1
1 1 1 1 1 1 1 1 1 1 1 1 1 1 1 1 1 1 1 1 1 1 1 1 1 1 1 1 1 1 1 1 1 1 1 1 1 1 1 1 1 1 1
1 1 1 1 1 1 1 1 1 1 1 1 1 1 1 1 1 1 1 1 1 1 1 1 1 1 1 1 1 1 1 1 1 1 1 1 1 1 1 1 1 1 1
1 1 1 1 1 1 1 1 1 1 1 1 1 1 1 1 1 1 1 1 1 1 1 1 1 1 1 1 1 1 1 1 1 1 1 1 1 1 1 1 1 1 1
1 1 1 1 1 1 1 1 1 1 1 1 1 1 1 1 1 1 1 1 1 1 1 1 1 2 2 9 12 12 12 12 12 12 21 1 1 1 1 1 1 1 1
1 1 1 1 1 1 1 1 1 1 1 1 1 1 1 1 1 1 1 1 1 1 1 1 2 2 2 10 13 13 13 13 13 13 7 1 1 1 1 1 1 1 1
1 1 1 1 1 1 1 1 1 1 1 1 1 1 1 1 1 1 1 1 1 1 1 2 2 2 2 10 13 13 13 13 13 13 7 1 1 1 1 1 1 1 1
1 1 1 1 1 1 1 1 1 1 1 1 1 0 0 0 0 0 0 0 0 0 0 0 0 19 4 11 14 14 14 14 14 14 17 1 1 1 1 1 1 1 1
1 1 1 1 1 1 1 1 1 1 1 0 0 0 0 0 0 3 3 3 0 0 0 0 0 0 0 0 0 8 2 2 2 2 3 1 1 1 1 1 1 1 1
1 1 1 1 1 1 1 1 1 1 0 0 0 0 0 0 0 3 3 3 0 0 0 0 0 0 0 0 0 0 19 2 2 4 1 1 1 1 1 1 1 1 1
1 1 1 1 1 1 1 1 1 0 0 0 0 19 0 0 0 0 3 0 0 0 0 0 0 0 0 0 0 0 0 0 4 4 1 1 1 1 1 1 1 1 1
1 1 1 1 1 1 1 1 0 0 0 0 0 0 0 0 0 0 0 0 0 19 0 0 0 0 0 0 0 0 0 0 0 6 6 6 1 1 1 1 1 1 1
1 1 1 1 1 1 1 1 0 0 0 5 0 0 0 0 0 0 0 0 0 0 0 0 5 3 5 0 0 0 19 0 0 0 6 6 1 1 1 1 1 1 1
1 1 1 1 1 1 1 1 0 0 20 5 20 0 0 0 0 18 0 0 0 0 0 0 3 20 3 0 0 0 0 0 22 24 26 6 1 1 1 1 1 1 1
1 1 1 1 1 1 1 1 0 5 5 5 5 5 0 0 0 0 0 0 0 0 0 0 5 3 5 0 0 0 0 0 23 25 27 1 1 1 1 1 1 1 1
1 1 1 1 1 1 1 1 0 0 20 5 20 0 0 0 0 0 0 0 0 0 0 0 0 0 0 0 0 0 0 0 0 0 6 6 1 1 1 1 1 1 1
1 1 1 1 1 1 1 1 0 0 0 5 0 0 0 0 0 0 0 0 0 0 19 0 0 0 0 0 0 18 0 0 0 6 6 6 1 1 1 1 1 1 1
1 1 1 1 1 1 1 1 0 0 0 0 0 0 0 18 0 0 0 0 0 0 0 0 0 0 0 0 0 0 0 0 0 6 6 1 1 1 1 1 1 1 1
1 1 1 1 1 1 1 1 0 0 0 0 0 0 0 0 0 0 0 0 0 0 0 0 0 0 0 0 0 0 0 0 0 6 6 1 1 1 1 1 1 1 1
1 1 1 1 1 1 1 1 0 0 0 0 18 0 0 0 0 0 0 0 18 18 0 0 0 0 0 0 0 0 0 0 0 6 6 1 1 1 1 1 1 1 1
1 1 1 1 1 1 1 1 19 0 0 0 0 0 0 0 0 0 0 0 0 18 0 0 0 0 0 0 18 0 0 0 0 6 6 1 1 1 1 1 1 1 1
1 1 1 1 1 1 1 1 1 1 6 0 0 0 0 0 0 0 0 0 0 0 0 0 0 0 0 0 0 0 0 0 6 6 1 1 1 1 1 1 1 1 1
1 1 1 1 1 1 1 1 1 1 1 6 6 3 3 3 0 0 0 0 0 0 0 19 4 4 0 0 0 0 0 0 6 1 1 1 1 1 1 1 1 1 1
1 1 1 1 1 1 1 1 1 1 1 1 6 19 3 19 19 18 0 0 0 0 19 4 4 4 4 0 0 0 0 6 1 1 1 1 1 1 1 1 1 1 1
1 1 1 1 1 1 1 1 1 1 1 1 1 1 1 1 1 1 1 1 1 1 6 6 6 6 6 6 6 6 6 6 1 1 1 1 1 1 1 1 1 1 1
1 1 1 1 1 1 1 1 1 1 1 1 1 1 1 1 1 1 1 1 1 1 1 6 6 6 6 6 6 6 6 6 1 1 1 1 1 1 1 1 1 1 1
1 1 1 1 1 1 1 1 1 1 1 1 1 1 1 1 1 1 1 1 1 1 1 1 1 1 6 6 6 6 6 6 1 1 1 1 1 1 1 1 1 1 1
1 1 1 1 1 1 1 1 1 1 1 1 1 1 1 1 1 1 1 1 1 1 1 1 1 1 1 1 1 1 1 1 1 1 1 1 1 1 1 1 1 1 1
1 1 1 1 1 1 1 1 1 1 1 1 1 1 1 1 1 1 1 1 1 1 1 1 1 1 1 1 1 1 1 1 1 1 1 1 1 1 1 1 1 1 1
1 1 1 1 1 1 1 1 1 1 1 1 1 1 1 1 1 1 1 1 1 1 1 1 1 1 1 1 1 1 1 1 1 1 1 1 1 1 1 1 1 1 1